Mumbai (Maharashtra)  --->  Delhi (Delhi)
Bengalooru (Karnataka)  --->  Kolkata (Bengal)
Chennai (Tamil Nadu)  --->  Ahmadabad (Gujarat)
Hyderabad (Andhra Pradesh)  --->  Pune (Maharashtra)
Surat (Gujarat)  --->  Kanpur (Uttar Pradesh)
Jaipur (Rajasthan)  --->  Lucknow (Uttar Pradesh)
Nagpur (Maharashtra)  --->  Indore ()
Patna (Bihar)  --->  Bhopal (Madhya Pradesh)
Ludhiana (Punjab)  --->  Agra (Uttar Pradesh)
Vadodara (Gujarat)  --->  Gorakhpur (Haryana)
Nasik (Maharashtra)  --->  Pimpri (Maharashtra)
Kalyan (Maharashtra)  --->  Thane (Maharashtra)
Meerut (Uttar Pradesh)  --->  Faridabad (Haryana)
Ghaziabad (Uttar Pradesh)  --->  Rajkot (Gujarat)
Benares (Uttar Pradesh)  --->  Amritsar (Punjab)
Allahabad (Uttar Pradesh)  --->  Vishakhapatnam (Andhra Pradesh)
Jabalpur ()  --->  Haora (Bengal)
Aurangabad (Maharashtra)  --->  Solapur (Maharashtra)
Srinagar (Jammu and Kashmir)  --->  Coimbatore (Tamil Nadu)
Jodhpur (Rajasthan)  --->  Chandigarh (Chandigarh)
Madurai (Tamil Nadu)  --->  Guwahati (Assam)
Gwalior (Madhya Pradesh)  --->  Vijayawada (Andhra Pradesh)
Mysore (Karnataka)  --->  Ranchi (Jharkhand)
Hubli (Karnataka)  --->  Jalandhar (Punjab)
Thiruvananthapuram (Kerala)  --->  Salem (Tamil Nadu)
Tiruchchirappalli (Tamil Nadu)  --->  Kota (Rajasthan)
Bhubaneshwar (Orissa)  --->  Aligarh (Uttar Pradesh)
Bareilly (Uttar Pradesh)  --->  Moradabad (Uttar Pradesh)
Bhiwandi (Maharashtra)  --->  Raipur (Chhattisgarh)
Gorakhpur (Uttar Pradesh)  --->  Bhilai (Chhattisgarh)
Jamshedpur (Jharkhand)  --->  Cochin (Kerala)
Amravati (Maharashtra)  --->  Cuttack (Orissa)
Bikaner (Rajasthan)  --->  Warangal (Andhra Pradesh)
Bhavnagar (Gujarat)  --->  Guntur (Andhra Pradesh)
Dehra Dun (Uttarakhand)  --->  Durgapur (Bengal)
Ajmer (Rajasthan)  --->  Ulhasnagar (Maharashtra)
Kolhapur (Maharashtra)  --->  Shiliguri (Bengal)
Asansol (Bengal)  --->  Jamnagar (Gujarat)
Saharanpur (Uttar Pradesh)  --->  Gulbarga (Karnataka)
Bhatpara (Bengal)  --->  Jammu (Jammu and Kashmir)
Ujjain (Madhya Pradesh)  --->  Nangi (Bengal)
Calicut (Kerala)  --->  Tirunelveli (Tamil Nadu)
Malegaon (Maharashtra)  --->  Jalgaon (Maharashtra)
Akola (Maharashtra)  --->  Belgaum (Karnataka)
Gaya (Bihar)  --->  Udaipur (Rajasthan)
Korba (Chhattisgarh)  --->  Bokaro (Jharkhand)
Mangalore (Karnataka)  --->  Jhansi (Uttar Pradesh)
Nellore (Andhra Pradesh)  --->  Tiruppur (Tamil Nadu)
Quilon (Kerala)  --->  Panihati (Bengal)
